109584 words
calculating divisions
on stufe 1
on stufe 2
on stufe 3
on stufe 4
on stufe 5
on stufe 6
on stufe 7
on stufe 8
on stufe 9
on stufe 10
on stufe 11
on stufe 12
on stufe 13
on stufe 14
on stufe 15
on stufe 16
on stufe 17
on stufe 18
on stufe 19
on stufe 20
on stufe 21
on stufe 22
on stufe 23
on stufe 25
on stufe 28
233685 words
calculating divisions
on stufe 3
on stufe 4
on stufe 5
on stufe 6
on stufe 7
on stufe 8
on stufe 9
on stufe 10
on stufe 11
on stufe 12
on stufe 13
on stufe 14
on stufe 15
on stufe 16
on stufe 17
on stufe 18
on stufe 19
on stufe 20
on stufe 21
on stufe 22
on stufe 23
on stufe 24
on stufe 25
on stufe 26
on stufe 27
on stufe 28
on stufe 29
on stufe 30
on stufe 31
on stufe 32
on stufe 33
on stufe 34
on stufe 35


processing division 2

rf	fr
mf	fm
yr	ry
rd	dr
md	dm
wk	kw
hp	ph
rn	nr
ie	ei
tm	mt
ow	wo
iv	vi
ay	ya
lh	hl
ut	tu


processing division 3

him	ihm
rec	cer
rim	mir
dot	tod
ref	fer
mea	mae
zip	piz
adv	avd
gad	dag
rah	ahr
sew	wes
afb	bfa
sib	bis
mkt	tkm
flu	ulf
nog	gon
kip	pik
sob	bos
soc	cos
nag	ang
nae	nea
cur	cru
cud	duc
hap	hpa
zed	dez
cpl	plc
zap	paz
hew	weh
avg	vag
esp	spe
reb	erb
sui	ius
jar	raj
hue	heu
hum	muh
hup	puh
tad	dat
cog	goc
ibm	bim
taw	wat
ifs	fis
pep	epp
fie	fei
mew	wem
jai	jia
irk	kir
ask	ska
ism	sim
rid	dir
ope	epo,poe
amu	mau,uma
moi	omi,mio
sot	ost,ots
uhs	hus,shu
sum	mus,ums
ail	ali,lai
ago	goa,gao
ado	oda,dao
usa	aus,sau
aim	ami,mai,mia


processing division 4

moth	thom
ribs	birs
nays	sayn
ussr	russ
ursa	raus
urge	ruge
mibs	bims
roil	lori
lash	hals
even	vene
lard	radl
lank	klan
nigh	hing
bide	dieb
ropy	opry
fens	senf
kudo	doku
koan	kano
roue	euro
unco	cuno
blah	halb
ukes	kues
ugli	iglu
zany	zyan
mere	meer
boar	bora
boff	offb
noon	nono
twit	witt
boob	bobo
bort	brot
nosh	sohn
tuts	tust
nosy	sony
auks	ukas
aahs	haas
rugs	grus
braw	warb
jots	jost
bred	derb
joke	koje
nuke	unke
rusk	kurs
bulk	klub
jail	ilja
vino	novi
trod	dort
viol	oliv
vips	visp
loan	laon
obit	tobi
yins	isny
sacs	cass
okra	karo
olla	lola
omit	timo
flab	falb
enow	owen
engr	gern
oryx	roxy
tole	leto
toil	tilo
toes	oste
mule	ulme
toad	dato
pail	pali
wail	wali
wain	iwan
fled	feld
loup	lupo
tilt	litt
chaw	wach
thug	guth
chez	zech
chia	chai
chid	dich
peen	epen
peep	pepe
inca	cain
chub	buch
peps	sepp
pert	petr
tent	nett
claw	calw
clue	luce
tart	trat
lute	leut
coir	rico
hunk	kuhn
hues	uhse
yell	lyle
howl	wohl
flew	welf
hoot	otho
sulk	klus
honk	kohn
hone	ohne
balk	kalb
whee	wehe
hive	vieh
stir	rist
poop	popo
hies	sieh
sash	hass
stem	mets
foam	mofa
hers	sehr
fore	orfe
moot	moto
harp	phra
amah	maha
curs	crus
wile	weil
pros	spor
guar	grau
grot	trog
grew	werg
efts	fest
frag	graf
soot	soto
alai	alia
pule	lupe
deed	dede
durn	rund
gown	wong
govt	vogt
gook	koog
slue	lues
ahoy	hoya
raze	reza
slew	wels
glop	plog
glob	blog
dunk	kund
duet	deut
skim	kims
agha	haag
sits	isst
sirs	riss
duel	lude
writ	wirt
mirk	krim
rata	tara
dins	sind
sibs	biss
afar	afra
shes	hess
dreg	gerd
rads	sadr
wore	rowe
furl	flur
dorm	mord
dram	darm
orch	chor,roch
racy	cray,cary
gets	gest,steg
ghee	gehe,hege
urea	auer,raue
mica	cima,imac
glee	egel,lege
ague	auge,gaue
dele	edle,edel
alar	aral,lara
alas	saal,sala
egis	sieg,geis
cosh	scho,ochs
leal	ella,alle
amyl	lamy,maly
lark	klar,karl
hors	rosh,sohr
hued	hude,ehud
lace	cale,alec
orig	giro,igor
bite	ebit,beit
arks	sark,kars
erne	eren,rene
ions	inso,sion
rube	bure,buer
brat	trab,bart
turk	kurt,truk
vain	naiv,ivan
atma	maat,mata,tama
tzar	arzt,ratz,zart
gila	gail,liga,agil
moan	oman,mona,amon
hest	seht,seth,steh
tine	eint,niet,tein
sane	nase,asen,sean
arum	amur,maru,umar,raum
roan	oran,arno,aron,nora
kine	nike,knie,kien,kein
bile	lieb,leib,blei,biel,beil
roam	omar,roma,mora,amor,amro
dine	dien,dein,neid,nied,iden


processing division 5

beery	beyer
bulks	klubs
abide	dabei
afrit	tarif
araks	sakra
memos	somme
issue	susie
eyers	reyes
buses	busse
muled	mulde
trued	trude
cabin	bican
rewin	erwin
merge	regem
iodin	indio
oculi	lucio
looks	sokol
ogler	orgel
ohing	honig
trapt	pratt
voted	devot
okras	oskar
wists	wisst
older	rodel
meres	emser
vomit	motiv
aglet	legat
aglow	wolga
faery	freya
carat	carta
toted	detto
mimer	immer
fairs	frais
torcs	corts
osier	rosie
torah	thora
carpi	capri
achoo	ochoa
toots	ottos
farer	farre
ashes	hasse
tooth	hotto
instr	stirn
tonic	conti
aspca	scapa
wants	wanst
loads	saldo
toffs	stoff
visas	sivas
asses	sasse
inker	rinke
inked	kinde
packs	spack
vinic	vinci
vined	diven
ingot	tonig
fasts	fasst
litho	thilo
infra	farin
resee	reese
tinge	neigt
rivet	viert
rerun	urner
airer	arier
chair	raich
pants	spant
chalk	hackl
inept	pinte
chant	nacht
lisle	ellis
chard	drach
pasha	haspa
muted	demut
thyme	mythe
ewing	wenig
patio	opiat
cheek	hecke
paves	vespa
reran	raren
chest	etsch
mudra	darum
chirk	kirch
lingo	login
feint	finte
chive	viech
theta	hatte
fella	falle
aport	porta
chops	posch
lined	linde
rooks	korso
penna	panne
bribe	biber
texan	taxen
etude	deute
chums	schmu
aurum	murau
verge	greve
pesky	skype
limed	milde
pharm	prahm
tells	stell
ethic	teich
fetes	feste
liked	kleid
tufts	stuft
myths	smyth
algid	adlig
ileal	leila
cloys	lycos
naifs	safin
taunt	untat
pions	spion
fewer	werfe
awing	wigan
cocas	sacco
abash	sabah
jonah	johan
erupt	puter
axils	salix
iambs	bisam
pirog	porig
ayahs	yasha
coirs	ricos
coked	docke
cokes	socke
babas	abbas
minim	mimin
erose	oeser
fifer	riffe
allow	allwo
tabla	talab
synod	dyson
manly	lyman
plots	stolp
hours	horus
levee	eleve
acute	ceuta
sumac	camus
letup	tulpe
pocks	spock
brats	starb
honed	hoden
minks	minsk
menus	musen
homes	moshe
filth	hilft
zeros	zores
stung	gunst
apeek	kapee
ensue	neues
hoggs	goghs
utter	rutte
safes	fasse
stopt	spott
stony	tyson
amahs	hamas
stole	lotse
whore	woher
hirer	ihrer
mamie	imame
hinds	sindh
hilts	stihl
aeons	oasen
legit	liegt
whole	wohle
corer	cerro
porks	korps
porns	sporn
urged	grude
yerba	bayer
stash	hasst
leech	elche
ameer	armee
heman	hamen
stags	sagst
sakes	kasse
cower	crowe
poxed	podex
flake	falke
enfin	finne
fleer	elfer
squat	quast
creak	acker
hazer	harze
hazel	zahle
baton	anbot
crepy	percy
haver	havre
baulk	kabul
croci	ricco
bourn	bruno
zesty	zyste
amiss	missa
refit	reift
cuish	uschi
halve	havel
haler	rahel
haled	halde
emeer	meere
hails	salih
amort	otmar
jutes	sujet
focal	falco
latch	lacht
gutta	taugt
unwed	wunde
troop	porto
schmo	mosch
spays	passy
beget	gebet
larva	valar
gulfs	flugs
begot	gebot
while	wiehl
guile	ligue
larks	karls
schul	luchs
davit	dativ
belch	blech
eikon	ikone
prune	puren
grots	sorgt
groin	ringo
sours	russo
sough	hugos
sorts	tross
grief	greif
benes	besen
bents	nebst
greek	gerke
tweet	wette
edema	medea
somas	samos
berth	breth
nighs	singh
grata	targa
grasp	prags
rebbe	ebber
twine	weint
soaps	passo
graft	fragt
betel	lebte
snots	sonst
pupal	pulpa
deign	dinge
unmet	muten
ladle	della
delve	velde
boned	boden
gored	droge
wrath	wahrt
anele	elena
frags	grafs
anent	tanne
gonad	dogan
rawer	werra
fraud	drauf
glove	vogel
boils	blois
globs	blogs
slabs	blass
freon	foren
bogie	obige
skuas	kasus
skeet	sekte
giros	rosig
krait	tarik
biont	botin
unfed	funde
admit	damit
luxes	lexus
gigas	gasig
dicta	tadic
giber	brieg
seems	messe
drams	darms
getup	puget
weedy	dewey
silex	exils
frump	rumpf
knife	finke
genii	einig
ankus	kanus
weens	wesen
weeny	newey
knelt	lenkt
lyric	cyril
kneed	denke
shute	hutes
raker	karre
gaunt	nugat
bleed	lebed
blued	budel
unarm	namur
unapt	punta
shies	hiess
kited	edikt
zoner	renzo
sensu	neuss
shawl	walsh
ganef	fange
gamin	gmina
mould	modul
umbel	blume
sexes	essex
doled	dolde
mound	mundo
ditch	dicht
udder	drude
gager	agger
mourn	munro
mists	misst
turfs	surft,frust
sheen	sehne,sehen
noels	olsen,losen
burst	strub,brust
fable	falbe,fabel
retie	tiere,eiter
nodal	naldo,adlon
ankle	laken,alken
anise	siena,asien
isles	seils,liess
sines	seins,nisse
loons	solon,olson
rheum	herum,umher
glebe	beleg,gelbe
glees	segel,gelse
arums	raums,masur
kenos	kosen,noske
puton	punto,upton
unled	nudel,luden
nines	sinne,ennis
gorge	rogge,georg
soars	rossa,rosas
laker	karel,klare
yeast	yates,yeats
grebe	berge,geber
belie	leibe,liebe
foots	sooft,fotos
begun	bunge,guben
began	bange,gaben
elide	leide,diele
prone	poren,opern
foams	famos,mofas
lathe	thale,halte
beaut	baute,taube
emend	emden,mende
broke	kober,borke
crush	schur,rusch
amirs	samir,maris
sanes	assen,nasse
craal	carla,clara
antre	raten,arten
tolls	sollt,stoll
rehem	herme,hemer
coyer	royce,corey
heist	sieht,thies
ureal	aurel,lauer
riven	ervin,viren
leman	almen,malen
strum	sturm,turms
relet	leert,elter
bloke	kobel,kolbe
lense	selen,lesen
chads	schad,dachs
roams	ramos,osram
remap	rampe,amper
altos	stola,salto
sulfa	flaus,laufs
taken	kante,akten
ergot	troge,grote
brios	boris,orbis
erred	reder,derer
moles	mosel,melos
icker	rieck,ricke
abner	raben,narbe
tined	ident,dient
liker	klier,rilke
likes	silke,kiels
threw	wehrt,werth
tubes	beust,stube
their	reiht,hirte
chide	chedi,deich
choke	koche,hocke
spite	stipe,tipse,piste
chits	sicht,stich,tisch
inarm	arnim,armin,marin
chubs	schub,buchs,busch
aisle	alesi,elisa,elias
autre	tauer,traue,raute
brine	birne,brien,erbin
kneel	enkel,nelke,ekeln
enure	euren,reuen,neuer
genes	senge,segen,enges
rewed	weder,werde,wrede
wises	weiss,wessi,wisse
drone	ronde,roden,orden
nehru	huren,ruhen,uhren
pekin	kneip,pinke,piken
rhine	ihren,rhein,henri
beret	beter,erbte,ebert
ulnae	lauen,laune,leuna
biles	beisl,silbe,bilse,blies
bleak	kabel,kalbe,bakel,blake
trues	streu,sture,suter,uster
taker	karte,kater,tarek,kreta
siree	serie,riese,reise,eiser
baned	benda,bande,baden,abend
bites	siebt,seibt,betis,biest
barge	ergab,grabe,garbe,gebar
ashen	shane,sahne,sahen,hasen,hanse
lithe	thiel,hielt,heilt,leiht,leith
ingle	igeln,ligen,linge,nigel,elgin


processing division 6

inaner	rainen
reuses	sursee
penult	tulpen
latens	lasten
peplum	plumpe
merman	rammen
churns	schnur
lasses	elsass
perter	perret
peruke	keuper
termer	remter
tercel	lecter
marred	marder
tepees	pesete
begets	gebets
beggar	bagger
penile	peilen
tenses	nestes
untrue	untreu
begirt	ergibt
phones	hopsen
retire	reiter
behalf	befahl
larker	klarer
nettle	letten
clamor	colmar
larder	radler
newest	westen
pickle	pickel
immune	mumien
apodal	apolda
revoir	ivorer
extent	texten
winned	winden
minter	termin
zenith	hintze
techie	teiche
unshed	hundes
nibble	bibeln
pilose	poleis
bendee	beende
themes	themse
unseal	lausen
nicked	dicken
illest	stille
unsafe	saufen
nicker	ricken
thence	echten
cloths	schlot
pinker	repnik
taxies	eisaxt
faired	frieda
muffle	muffel
berths	herbst
rhymer	myrrhe
tavern	vertan
tauter	traute
besets	bestes
albeit	abteil
taunts	staunt
beside	beides
pinole	loipen
lakier	eiklar
choler	locher
unpent	neptun
wanner	warnen
modula	moldau
pipets	stippe
unmade	daumen
beckon	bocken
biases	baisse
tapper	trappe
riffle	riffel
pitmen	piment
nimble	milben
aldrin	irland
bicker	bricke
alephs	haspel
nipped	dippen
nipper	rippen
tanked	dankte
rifled	friedl
hyenas	haynes
marges	regsam
tanged	tagend
fanned	fanden
unkept	punkte
tamals	maltas
bigger	bergig
alexia	axiale
labium	malibu
yerbas	bayers
taking	kantig
wailer	waleri
cometh	mochte
bilges	selbig
fanner	farnen
bingos	gibson
binned	binden
humeri	reihum
pleura	plauer
chocks	schock
lunars	ruslan
rilled	diller
kraals	sakral
arable	laaber
biotas	tobias
kopjes	skopje
howler	wohler
lorans	larson
waffle	waffel
wading	wigand
merger	germer
farers	fraser
mulier	muriel
hosier	roheis
surges	erguss
lopped	doppel
surfed	freuds
nobler	lebron
wimple	wimpel
uncase	usance
summed	dummes
sumach	schaum
sulker	klerus
thieve	hievte
allege	legale
mealie	amelie
unbent	bunten
unbars	brauns
archly	charly
bleach	blache
bleaks	kabels
submit	bistum
polite	pilote
rinser	sirren
styler	sylter
stupas	pussta
lunate	lauten
strums	sturms
umiaks	kumasi
umbrae	baumer
bloats	oblast
streps	presst
ripely	ripley
storms	stroms
allium	millau
ullage	gaulle
molter	olmert
stoned	tosend
longes	glosen
longer	orgeln
stitch	sticht
pontes	posten
kinema	kamine
mumble	bummel
kilted	delikt
armlet	malter
zonked	donezk
vomits	motivs
cornet	centro
hiatal	thalia
hewing	hinweg
logier	glorie
fathom	hofamt
hereon	heroen
kettle	klette
herbal	halber
fatten	taften
ritzes	sitzer
monger	morgen
poteen	poeten
hemmed	mehmed
kerned	denker
stanza	ansatz
almost	alstom
lodges	goldes
wields	wildes
monied	medion
zoners	zensor
mazily	yilmaz
bolder	brodel
heired	heider
faunal	anlauf
heiled	heidel
kenned	denken
hegira	haiger
bolter	tobler
heckle	heckel
prague	graupe
bonded	bodden
favour	vorauf
murine	mineur
monish	shimon
locket	lockte
chimes	mische
widens	windes
boners	sorben
bonier	oberin
hearth	hertha
bonnet	benton
murker	merkur
crease	cesare
hazers	harzes
fawner	warfen
twined	windet
abatis	bastia
twills	willst
ashing	sahnig
creole	ercole
karats	kaarst
crimea	mercia
hating	hantig
sprees	presse
hastes	hasste
askers	krasse
aspens	passen
harlot	lothar
boreal	labore
borons	robson
spoken	knospe
hanked	handke
noshes	sohnes
bother	bohrte
llanos	allons
primos	promis
nosing	sonnig
prinks	knirps
tusker	kruste
bourgs	burgos
turtle	lutter
chills	schill
bowleg	weblog
vireos	erosiv
hackle	kachel
beaked	debeka
violas	valois
turned	rundet
lunger	lugner
litmus	multis
vinier	irvine
turfed	durfte
turbot	brutto
turbit	tribut
gunner	ungern
gunnel	lungen
gunned	endung
melted	meldet
mallet	metall
malled	alldem
guilts	lustig
guilds	duslig
upmost	postum
chides	schied
dauber	erdbau
mimeos	mimose
moolas	salomo
dazing	danzig
tulles	stulle
pruned	pudern
prunes	spuren
mooned	mondeo
feeing	feigen
tufter	futter
tufted	duftet
gripes	gipser
bribee	bieber
griots	rostig
achier	archie
bridle	bilder
evenly	evelyn
matzos	tomasz
deckle	deckel
nubias	anubis
brines	serbin
nubile	unlieb
grebes	berges
amicus	musica
nuclei	lucien
puking	punkig
mature	mauter
puling	plugin
gravel	verlag
aerify	fairey
soften	feston
brogan	bangor
nudest	stunde
aching	chiang
grants	strang
defier	friede
defile	fiedel
define	feinde
attire	tertia
linter	litern
trunks	strunk
soaker	koreas
attrib	britta
nudges	gesund
degree	gerede
truing	turing
jetsam	matjes
bruits	tribus
brunts	brunst
lingua	launig
mopier	premio
fellas	falles
lunker	runkel
gorger	gregor
demise	diesem
amoles	salome
roomer	romero
buckle	buckel
matron	tonarm
felted	detlef
trowel	wolter
demons	mondes
trover	trevor
verite	vierte
denned	endend
smeary	ramsey
goners	sorgen
buenas	bauens
golfed	geldof
linacs	niclas
goblet	gelobt
chests	sechst
aurums	maurus
gnomes	genoms
gnawed	gewand
nurses	russen
glutei	eilgut
sleeks	kessel
gloves	vogels
bunged	gebund
gloats	lostag
fencer	ferenc
slaked	skalde
venine	vienne
detach	dachte
amrita	marita
burgee	beuger
ethnic	nichte
triter	ritter
likest	kleist
skewer	werkes
skeins	kissen
throat	trotha
itemed	meidet
itched	dichte
ethane	athene
burnie	brunei
oakums	moskau
burred	bruder
rotate	teatro
issues	suisse
ginner	ringen
busher	hubers
sirree	reiser
isobar	barsoi
busmen	bumsen
gibers	griebs
etches	echtes
morose	moores
dieing	neidig
gibbet	begibt
sinews	wissen
naiads	dianas
germen	menger
octane	aceton
aidman	damian
mortar	torarm
sigmas	massig
mosaic	cosima
sicked	dickes
geeing	geigen
axemen	examen
cagier	gracie
caking	nackig
gauzes	zusage
axlike	lexika
triads	astrid
feting	giften
gating	gigant
shoats	thasos
espies	speise
calico	calcio
pattee	tapete
gasman	mangas
gaslit	lastig
treble	erlebt
racier	carrie
babble	babbel
radian	adrian
uprise	epirus
garble	gabler
checks	scheck
gannet	genant
radish	rashid
woalds	oswald
gamest	gesamt
namers	masern
thymes	smythe
sextet	textes
wether	wehrte
lichis	chilis
backer	bracke
render	redner
nances	cannes
pastry	partys
ergots	sorgte
canned	dancen
wester	wertes
bating	angibt
gabber	bergab
napper	rappen
libers	silber
pastas	passat
abhors	hasbro
fusels	fussel
onward	randow
valuer	valeur
senses	essens
sensed	dessen
sennas	nassen
raking	rankig
mentis	misten
bagful	abflug
donees	odense
towing	twingo
towies	soweit
donnas	sodann
funned	funden
fungal	anflug
semite	meiste
baguet	gebaut
touter	tourte
agates	gaseta
nasals	anlass
fueled	feudel
mingle	gmelin
selfed	feldes
baited	ebitda
ankles	skalen
doyens	synode
figure	feurig
pashas	passah
paseos	pessoa
midges	demsig
drafts	darfst
leaner	realen
drakes	kaders
ageist	eistag
orgeat	ortega
levies	vieles
epochs	posche
anneal	alanen
masons	samson
menthe	themen
balker	brakel
welted	wedelt
chards	drasch
drongo	gordon
carnie	racine
drover	vorder
fridge	fedrig
sedans	sandes
eonian	onanie
fresno	sofern
moulds	moduls
rather	harter
lethes	stehle
moults	mutlos
lethal	hallte
rushee	heuser
yonker	orkney
balsas	ablass
dulses	dussel
lesser	lesers
mildew	wildem
casbah	asbach
dunner	runden
fining	finnig
cashew	wachse
outran	touran
finned	finden
razing	ranzig
parkas	kaspar
lusher	suhler
fought	hofgut
tonger	gernot
lensed	elends
yonder	rodney
moused	usedom
basses	besass
banned	banden
navels	valens
toking	knotig
rebbes	ebbers
lender	ledern
tokens	kosten
rebeck	becker
sables	blasse
firing	firnig
owning	wonnig
lemmas	sammle
inputs	putins
answer	wrasen
effort	offert
firsts	frisst
redone	doreen
redrew	werder
sacrum	marcus
schmoe	mosche
fonder	fronde
barfed	bedarf
barges	grabes
ensure	unsere
basins	bassin
elmier	meiler
lecher	lerche
packet	packte
neater	renate
tittle	titelt
titter	tritte
paddle	paddel
embalm	bammel
negate	etagen
sagier	gareis
scales	cassel
embers	bremse
necked	decken
sayers	yasser
sawing	wagnis
reeler	leerer
savour	voraus
inhale	haniel
tisane	saiten
flumed	umfeld
fluids	sulfid
emmets	stemme
sauted	staude
enroll	rollen
barque	querab
refilm	filmer
enrobe	oberen
leches	scheel
antics	sancti
tippet	tippte
tipped	peptid
paling	planig
ennuis	uneins
chalks	schalk
encamp	campen
tinter	trient
sashes	hasses
refund	freund
sarape	paares
refuse	feuers
rehire	reiher
lefter	elfter
tinkle	klient
sangha	ghanas
engirt	tigern
regear	geraer
flense	felsen
barter	traber
sambos	amboss
chaffs	schaff
salute	lautes
flaunt	unflat
regret	erregt
chosen	cohens,ochsen
reglue	lueger,greuel
refute	freute,feuert
chairs	charis,arisch
refire	reifer,freier
larvae	varela,valera
saunas	assuan,nassau
urgent	gunter,trugen
nebule	bleuen,beulen
titles	titels,listet
anther	harten,erahnt
anthem	mahnte,methan
nearby	barney,bayern
tenant	annett,tanten
rebels	selber,elbers
relent	lernte,eltern
seabag	abgase,absage
reline	leiern,leiner
bander	brenda,darben
casket	sackte,staeck
intake	aktien,antike
dunker	kruden,kurden
rattus	stuart,statur
learns	larsen,lasern
letups	pustel,stulpe
orgies	rosige,sergio
abrade	baader,adebar
ranees	arsene,serena
ruddle	dudler,dulder
doblas	solbad,sobald
canker	ackern,neckar
galena	anlage,angela
lichee	leiche,eichel
belies	beisel,siebel
oilman	molina,milano
renege	engere,greene
patens	tapsen,spaten
oglers	gloser,reglos
rennin	rinnen,innern
sheens	hessen,sehens
shines	hessin,hissen
lienee	neelie,eileen
gentle	gelten,legten
tinker	kretin,trinke
etcher	rechte,echter
butane	tauben,bauten
dewier	wieder,weider
chafes	faches,schafe
maitre	emirat,matrei
slakes	kassel,klasse
repine	preien,peiner
verier	revier,vierer
vernal	larven,nerval
linger	ringel,reling
atones	sonate,easton
breech	breche,becher
brazen	zabern,banzer
assure	sauser,ausser
musing	signum,mingus
nether	rethen,herten
beaned	ebenda,abende
haired	haider,dahier
twines	wisent,westin
zanier	anreiz,arznei
bonder	bodner,droben
monies	simone,simeon
almner	malern,marlen
hernia	hainer,hieran
chirps	pirsch,sprich
arguer	guerra,grauer
meager	graeme,magere
polkas	polska,pokals
kneels	enkels,senkel
manure	mauern,mauren
anuses	sausen,aussen
unfree	freuen,feuern
kraits	krista,arktis
wreath	warthe,wahrte
bindle	blinde,bilden
nipple	lippen,nippel
absent	basten,besant
pirate	partie,partei
benign	bingen,beginn
unread	renaud,dauern
chords	dorsch,drosch
retake	rakete,erekat
fainer	fairen,anrief
ureter	teurer,reuter,treuer
tenets	testen,steten,nettes
amulet	taumel,lautem,meltau
hennas	sahnen,hannes,hansen
entail	anteil,talein,latein
thrice	riecht,richte,reicht
relets	estrel,lester,elster
droner	ordner,ordern,dorren
reties	tieres,reiste,stiere
linens	inseln,lenins,linsen
ranker	knarre,karner,karren
snares	rassen,rasens,nasser
enamor	romane,aromen,marone
feline	fielen,liefen,feilen
anklet	talken,takeln,kalten
nerves	versen,nevers,severn
charms	ramsch,marsch,scharm
breach	brache,bacher,erbach
teeing	geeint,neigte,eignet
tangle	anlegt,langte,galten
earful	erlauf,laufer,fauler
rodent	erdton,ordnet,dorten
wanter	anwert,warten,warnte
cheers	escher,schere,scheer
either	reihte,heiter,hertie
belier	leiber,lieber,bieler
berets	strebe,sterbe,bester
amuser	raumes,masure,mauser
banter	traben,braten,barnet
latest	sattel,lastet,lestat
chelas	lachse,lasche,achsel,schale
elites	teiles,stiele,steile,leiste
unseat	austen,sutane,staune,stauen
relies	leiser,seiler,eisler,eilers
minora	romani,romain,marino,marion,maroni
ermine	riemen,reinem,reimen,eimern,meiner
entire	tieren,rieten,reiten,nieter,eitern
rained	radien,ariden,darein,adrien,andrei,einrad
lieges	gleise,geleis,eselig,siegel,selige,geisel,seelig
riches	rische,riesch,reichs,sicher,schrie,schrei,schier
refine	riefen,reifen,fieren,freien,ferien,feiner,feiern,eifern


processing division 7

piggier	gieprig
resumer	sumerer
revises	sievers
revolts	verlost
factors	castorf
retaker	karrete
fainest	stefani
retaken	raketen
fairest	astfrei
faithed	fadheit
ribands	brandis
ribless	bisserl
fanners	fransen
respite	spreite
rimming	ingrimm
farrier	ferrari
resoled	erdelos
risible	ribisel
fathoms	amtshof
roached	rochade
fearing	infrage
felines	fliesen
replete	peterle
eurasia	isaraue
femoral	formale
ropable	oberalp
euchres	scheuer
abetted	debatte
rostrum	urstrom
ethenes	ehesten
fertile	liefert
fetcher	fechter
erudite	treueid
erratic	cartier
erotize	zoterei
ermines	meisner
ermined	endreim
erelong	erlogen
figured	freudig
ablates	betsaal
finches	fischen
rustics	curtiss
entwine	weinten
firearm	armreif
entrain	interna
sabring	singbar
entered	redeten
ensurer	unserer
ensuant	staunen
ablings	bislang
fittest	stiftet
enrobes	erbosen
enrober	erobern
enrages	reagens
enquire	enrique
sailors	solaris
salines	einlass
engross	grossen
reifies	eisfrei
engraft	fragten
flanker	falkner
engorge	georgen
zilches	schleiz
engages	seegang
engaged	dagegen
regrets	gerster
regrade	gerader
flavour	vorlauf
enfants	sanften
samites	matisse
enemies	seemine
regimen	gremien
endorse	nordsee
endlong	gondeln
endleaf	edelfan
mideast	amtseid
fleshed	sehfeld
sandlot	ostland
sanseis	insasse
refuter	erfreut
enchant	nachten
enchain	chennai
enamour	amouren
enabled	beladen
satraps	spartas
flossie	fossile
flotsam	oftmals
refiner	frieren
reffing	griffen
embroil	mobiler
reeking	kriegen
reedier	rederei
elmiest	steilem
schemed	mesched
schisms	schmiss
schtick	schickt
redneck	drecken
eldrich	redlich
reddens	dresden
foreleg	erfolge
rebecks	beckers
rebater	berater
founder	neudorf
readmit	dietmar
foxfire	firefox
dustman	umstand
dusting	dunstig
dunnage	ungnade
ravened	evander
rattier	tierart
ducking	dickung
duckers	druckes
ratfink	infarkt
dryable	bradley
frigate	freitag
fritted	driftet
rankled	lenkrad
rangoon	organon
fueling	einflug
seltzer	stelzer
zestier	seziert
fulness	fusseln
ranched	drachen
funding	findung
funeral	flaneur
dooming	domingo
sennits	stinnes
gabbier	biegbar
serenes	essener
ditches	dichtes
ditcher	dichter
galleon	gallone
shaitan	ashanti
gametes	gesamte
shaking	skihang
shallot	haltlos
shanked	handkes
dispute	stupide
sharpen	phrasen
gantlet	glatten
shebeen	besehen
sheened	sehende
zeroing	zornige
garbler	arlberg
sheeter	therese
gaunter	agentur
gaveler	verlage
gawkers	gaswerk
shucker	schurke
gefilte	gefeilt
disband	sindbad
sighing	higgins
direful	urfidel
genteel	telegen
gentled	geltend
gentler	gelernt
gentles	stengel
geoidal	dialoge
gestate	tagetes
getable	ablegte
sitters	streits
skaldic	lidsack
gladier	adliger
skillet	klestil
skinned	sinkend
gleaned	geladen
destine	dienste
slakers	kassler
gnawers	wagners
slither	hitlers
slurped	sprudel
goldest	ostgeld
dentine	dienten
golfers	erfolgs
denotes	ostende
dengues	gesunde
demurer	remedur
gorgers	gregors
gorgets	gesorgt
demagog	modegag
sneaker	kaserne
gosling	losging
deluges	gesudel
deluged	gedudel
gothics	gotisch
snidely	lindsey
snippet	stippen
midyear	myriade
snorkel	kernlos
degauss	degussa
grafter	erfragt
soakers	karosse
punkest	punktes
grander	gardner
punches	puschen
defines	feindes
granter	gartner
granule	graulen
softies	softeis
grating	grantig
gravels	verlags
gravest	versagt
gravies	gervais
gravure	graveur
grazier	zigarre
greases	seegras
sonants	ansonst
greeter	erregte
gripers	sperrig
groaned	erdogan
spanker	kaspern
sparkle	kasperl
daubers	absurde
datchas	datscha
grutten	rettung
protons	rotspon
guilder	liudger
dandled	daddeln
gummier	gremium
absurds	bussard
gunlock	lockung
gushier	ruhiges
dabbing	bigband
prolate	portale
hailing	alinghi
spinach	panisch
handgun	ahndung
handles	handels
cryogen	conergy
crusher	schurre
hanging	hingang
hangman	hagmann
spoking	knospig
harlots	lothars
presoak	kapores
presift	pfister
preplan	rappeln
sprains	spirans
hatless	hasselt
preheat	haperte
crashed	schader
cranker	rackern
hearths	herthas
praters	erspart
pranked	parkend
hebraic	reibach
heckles	schekel
coveter	coverte
hefting	fighten
stammer	stramme
stander	erstand
hematic	eichamt
potteen	potente
potshot	hotspot
hemiola	leihoma
henbane	anheben
hennaed	nahende
starlit	stilart
henting	genthin
herbage	hergabe
abusage	ausgabe
statism	sittsam
corrida	ricardo
steerer	erstere
coronal	locarno
stepson	postens
cornets	costner
porches	porsche
hidable	heilbad
cordite	codiert
sticked	dickste
copters	spector
stifles	fliesst
hirable	heilbar
stoking	gnostik
strafes	erfasst
strikes	streiks
stroker	rektors
hollies	heillos
politer	poliert
homiest	ostheim
submits	bistums
hominem	monheim
sulfite	eisluft
sulkies	kulisse
sulphur	pulsuhr
sumachs	schmaus
summits	missmut
surfier	friseur
howlers	wehrlos
syllabi	sibylla
hulkier	heilkur
sylvian	sylvain
humeral	malheur
tabaret	rabatte
tabular	lautbar
tackier	aktrice
takeing	kantige
hutches	hutsche
talkier	artikel
tallies	liestal
tallows	ostwall
tambura	baumart
planner	planern
tanager	granate
tanbark	bankrat
tangler	erlangt
placoid	placido
cohorts	ostchor
pitches	pietsch
targets	ersttag
tatamis	mattias
pintail	platini
taunter	trauten
pinocle	policen
pinnate	pantine
clunker	ruckeln
cloying	coligny
ignoble	gobelin
pinions	spionin
ikebana	abenaki
pimento	piemont
techies	teiches
clearly	carlyle
retitle	erteilt
tektite	etikett
telesis	stiesel
pickers	spicker
clanked	landeck
photics	optisch
phoneys	hypnose
reverie	reviere
cithern	richten
abutter	betraut
terbium	umtrieb
terrane	erraten
peruses	perseus
perches	spreche
perched	erdpech
pepsine	piepsen
chunter	unrecht
thanker	kanther
chromes	morsche
penlite	pleiten
penises	speisen
thereof	teerhof
milkmen	klimmen
peering	giepern
thicker	kriecht
meltage	gemalte
inclose	conseil
thinner	hintern
chirker	kircher
chilean	laichen
chields	schilde
peakier	kaperei
chiders	driesch
chewier	weicher
chewers	schwere
cherish	hirsche
chemist	mischte
chemins	mischen
paupers	sappeur
cheeped	depeche
chawers	wascher
pastime	septima
pastils	spitals
tibetan	bettina
mimosas	massimo
charted	erdacht
indites	idstein
chantey	yachten
minorca	marconi
paretic	patrice
changer	chargen
written	wittern
parable	parabel
chamise	maische
chafers	scharfe
inflate	einfalt
panache	apachen
pallets	pastell
tipless	spielst
tippers	strippe
inhaled	heiland
titrant	antritt
tittles	stilett
toadies	estadio
toddler	troddel
cattish	attisch
toilets	ostteil
tongers	sorgten
overman	vorname
overlie	voliere
castors	castros
instals	stalins
cashier	cahiers
intense	steinen
ourself	uferlos
topless	stolpes
topmast	postamt
toppled	doppelt
carotin	cortina
caroler	arcelor
orgasms	sorgsam
tossers	strosse
orchids	dorisch
orbited	debitor
orators	rosarot
canthal	chantal
traduce	decatur
intoner	tonrein
olivine	violine
cankers	neckars
tramell	martell
trammel	lammert
oilskin	silikon
oilcans	nicolas
offense	offenes
callets	castell
tremens	mertens
tremors	stromer
tribade	abderit
inwards	darwins
bylines	libyens
obverts	verbots
obtuser	robuste
butches	besucht
triolet	teilort
itchier	ritchie
itching	nichtig
tritone	notiert
burgees	seeburg
burette	betreut
jaegars	jasager
bundled	buddeln
nutmeat	anmutet
bulkier	bierulk
bugbear	bergbau
trovers	vorerst
buckish	kubisch
trucked	druckte
trudger	gertrud
jestful	julfest
bruiter	urtrieb
trundle	trudeln
bromate	oberamt
trustee	steuert
broiled	oberlid
brogues	bourges
brocade	barcode
broaden	doberan
bretons	borsten
tundras	urstand
jousted	ostjude
turkois	skitour
bowlegs	weblogs
tussles	esslust
notates	toasten
wrinkle	winkler
twanged	gewandt
borstal	bartlos
tweeter	wertete
bonnets	besonnt
kelpies	eklipse
keratin	antiker
boggler	blogger
ketches	sketche
kettles	skelett
blunted	blutend
kilorad	kordial
tzigane	anzeigt
ullages	gaulles
bloater	alberto
kirkman	kramnik
blither	hilbert
blinded	bildend
blether	belehrt
bleater	retabel
bleared	erbadel
unasked	sekunda
bleaker	kerbela
blather	barthel
kneaded	dekaden
bitches	schiebt
knurled	dunkler
undrest	dursten
birches	schrieb
koppies	episkop
uneated	tauende
koreans	narkose
kuchens	kuschen
unlaces	clausen
lacteal	alcatel
betters	strebte
unmeant	anmuten
besting	besingt
lamella	allemal
niggler	gerling
lancers	carlsen
benthal	ablehnt
benison	bosnien
unseams	unmasse
nibbler	ribbeln
nibbled	dibbeln
laniard	rainald
lankier	karline
lansing	nilgans
lantern	lennart
laotian	anatoli
beliers	siebler
beetles	beseelt
beeline	beeilen
latched	dachtel
latened	landete
bedroll	bordell
launder	reuland
nervine	neverin
beastie	abseite
bearish	berisha
beanbag	abgaben
laxness	lanxess
beaches	seebach
leaches	chelsea
leadier	idealer
leakers	seeklar
batches	bestach
batcher	brachte
batched	bedacht
learned	leander
leather	erhalte
negates	seetang
leaving	lavigne
negated	tagende
lechers	selcher
basemen	besamen
ledgier	glieder
leeches	scheele
bartend	brandet
leftism	filmset
measles	melasse
needful	neufeld
legated	geadelt
banters	starben
banshie	eisbahn
banshee	absehen
lenient	entlein
leotard	odertal
banders	brandes
lesbian	blasien
lessens	sesseln
letches	schelte
vaguest	gustave
natters	starten
ballads	alsbald
balkier	kaliber
bailers	belisar
baffler	blaffer
nappier	papiern
namable	abmalen
vaunter	ventura
likened	kleiden
wrasses	wassers
limeade	mediale
austere	esterau
aurochs	chosrau
linable	labilen
lineate	anteile
augends	segunda
auberge	gebauer
attired	datiert
atriums	astrium
atoning	antigon
mutable	baumelt
muskrat	mastkur
assurer	urrasse
vintage	negativ
mushers	messuhr
asserts	strasse
arrived	vierrad
mumbler	bummler
mulches	muschel
wailers	waliser
lounged	neugold
waltzer	wetzlar
wangled	landweg
wanters	wartens
warless	walsers
apostle	apostel
aphasic	chiapas
mealier	malerei
lungers	gruseln
watches	watsche
waterer	erwarte
wearing	wegrain
lustier	urteils
weeding	gewinde
mouthed	hutmode
anoxias	saxonia
mourner	rumoren
anneals	annales
wennier	wienern
madrone	maroden
wetland	wandelt
mothier	heimtor
wherein	wiehern
morally	mallory
amongst	montags
whirled	rehwild
amerind	meinrad
mallets	metalls
whittle	welthit
montane	monaten
monomer	mormone
alumine	ilmenau
alumina	almunia
althorn	hornalt
mandrel	ermland
widener	weidner
monists	misston
almsmen	sammeln
adrenal	randale
wienies	eiswein
manlike	keinmal
wigeons	sowenig
mantids	imstand
alleger	legaler
wincher	wichern
wormers	wormser
moilers	reimlos
aldrins	irlands
albumen	baumeln
albedos	solebad
winkers	wirkens
markups	krampus
marring	armring
martian	martina
wirings	wirsing
witches	wischte
maskers	krassem
ageings	eisgang
misused	deismus
mistook	moskito
misterm	stimmer
mistake	skiteam
matless	seltsam
wooding	goodwin
matures	mausert
workday	kadyrow
tenches	stechen,teschen
relines	rieseln,leserin
trowels	wertlos,wolters
bencher	brechen,bechern
reusing	unsrige,usinger
muskier	umkreis,musiker
deaning	gennadi,engadin
regnant	renntag,gerannt
trueing	eitrung,eintrug
zaniest	eistanz,einsatz
petrols	postler,polster
entitle	enteilt,teilten
newsies	esswein,weissen
enabler	erlaben,alberne
aborter	roberta,oberrat
tertial	literat,alttier
metiers	mieters,meister
dareful	raufeld,fuldaer
generis	greisen,siegern
nettler	lettern,lettner
hunches	schuhen,huschen
lunches	schulen,luchsen
rainout	tournai,autorin
outrage	touareg,rotauge
epistle	spielte,epistel
ensures	unseres,neusser
lurches	schuler,urschel
notches	schoten,schonte
refines	reifens,friesen
snifter	fristen,finster
fleches	schleef,flechse
weening	gewinne,wenigen
riveter	vierter,verriet
ostrich	chorist,christo
dingier	rigiden,niedrig
sestine	steines,seitens
handcar	chandra,darnach
emeries	eismeer,meereis
wetness	stewens,westens
tangelo	tonlage,notlage
chimers	schirme,mischer
stereos	soester,orestes
runtier	turnier,turiner
prickle	prickel,pickerl
ginners	rensing,grinsen
chiasms	schisma,samisch
repines	preisen,persien
mirages	siegmar,maserig
alumnae	manuale,manuela
reefier	reifere,eiferer
cherubs	bursche,schuber
blintze	bitzeln,blitzen
englobe	belogen,geloben
flenses	fesseln,felsens
hingers	gehirns,sehring
skirted	kredits,diskret
wielder	wildere,derweil
skitter	streikt,strikte
hitches	ethisch,hitsche
ignites	steinig,einstig
scathed	datsche,schadet
blander	rebland,dalbern
knotter	kontert,kornett
bittern	britten,bittner
gannets	stangen,tangens
seeding	endsieg,gesinde
windage	wiegand,weigand
aliener	realien,lineare
aliened	daniele,idealen
pingers	springe,gipsern
baiters	basiert,beirats
stunned	dunsten,stunden
butanes	stauben,nestbau
tearier	eritrea,arterie
lichens	sicheln,nischel
stunner	unstern,unernst
chanted	dachten,dechant
entwist	twisten,twinset
veinlet	leviten,ventile
seiners	reisens,neisser
endears	anderes,rasende
ricksha	rikscha,karisch
ladrons	randlos,arnolds
fainter	tarifen,eintraf
lineage	geniale,einlage
matinal	laminat,maintal
shelter	strehle,stehler
bunches	buchsen,buschen
temples	stempel,tempels
linkers	kriseln,linkser
starver	travers,versart,verrats
winches	wischen,wichsen,schwein
watcher	erwacht,wachter,wertach
meanies	ameisen,amnesie,einsame
richens	sichern,schrien,schrein
ureters	reuters,steurer,streuer
filches	schlief,fleisch,elfisch
notable	abloten,oblaten,notabel
parches	sprache,pascher,schaper
chanter	anrecht,tranche,achtern
chasten	stachen,achtens,taschen
chitter	richtet,rettich,trichet
cholers	erlosch,solcher,schorle
tensile	stielen,steilen,leisten
almoner	normale,monreal,molaren
gunfire	riefung,reifung,figuren
fitters	streift,stifter,fristet
snakier	ankreis,kaisern,arsenik
tenners	sternen,ernsten,nestern
garbled	belgard,belgrad,dalberg,bargeld
ranches	raschen,crashen,scharen,nascher
rehinge	gehirne,geherin,ehering,ehinger
reinter	rentier,reitern,reinert,terrine
needier	niedere,nereide,edieren,einrede
authors	torhaus,suharto,haustor,rothaus
regents	stenger,stegner,engster,gestern,strenge
deleing	ledigen,liegend,elendig,edeling,gelinde
ethnics	stichen,sichten,tischen,schneit,scheint


processing division 8

ripeness	persiens
skitters	striktes
garottes	ostertag
antheral	anhalter
sketcher	ketscher
gauchest	geschaut
skeletal	kastelle
wielding	weidling
clatters	scarlett
wieldier	wilderei
asserted	desaster
gangrene	ergangen
bearskin	bankiers
genitors	rostigen
quatrain	antiquar
gesturer	guterres
adorable	adalbero
almoners	normales
gangland	landgang
brockets	rebstock
clubfoot	fotoclub
gladlier	grillade
taverner	verraten
tautened	andeutet
trundles	strudeln
glaziers	zierglas
teleport	polterte
alterant	tarantel
glitches	glietsch
brothier	oberhirt
bedouins	dubiosen
tasteful	testlauf
brunches	burschen
asterisk	kassiert
vineries	visieren
beechier	bereiche
sibilant	instabil
abstains	bastians
siameses	eismasse
goldurns	grundlos
gomorrah	gomorrha
goneness	genossen
puritans	rasputin
beelines	eisleben
tarsiers	eisstarr
beeriest	bereiste
shrewing	gershwin
pureness	preussen
shortest	stehrost
befriend	erbfeind
punchers	pruschen
taperers	ersparte
bugbears	bergbaus
shinleaf	hanfseil
breather	beharrte
graziers	ziergras
trotters	tretrost
bulgiest	blutiges
sherbets	herbstes
collates	castello
tannates	antasten
messmate	messeamt
grimiest	striemig
tanagers	antrages
belabors	borsalbe
groovers	vorsorge
groveler	vorleger
antipole	antilope
bumboats	obstbaum
shagreen	hersagen
shackles	schalkes
protects	prescott
guesting	steigung
bunchier	einbruch
guiltier	liturgie
severals	verlasse
waterier	warterei
gunstock	stockung
destines	dienstes
gustable	bluestag
unsocial	nicolaus
tailless	allseits
gamester	gesamter
serfages	fressage
serenest	seestern
gamelans	langsame
atropins	pastorin
profanes	sparofen
attaches	tatsache
benchers	scherben
bendable	abblende
probable	probabel
burliest	subtiler
halftone	altenhof
unseated	tausende
burnoose	osbourne
clashing	sanglich
antlered	alternde
antlions	stanniol
hanumans	hausmann
unripest	puristen
switcher	erwischt
harebell	halbleer
doorstep	torpedos
anviling	naivling
harmonic	ichroman
triplane	planiert
unriddle	dulderin
attester	startete
trioxide	oxidiert
triolets	ortsteil
harvests	verhasst
premiums	spermium
meringue	umgieren
hatchers	erhascht
clarinet	lanciert
dowering	irgendwo
hazelnut	zuhalten
selenide	seilende
preboils	lobpreis
preadult	plaudert
hearties	theresia
pralines	spiralen
gallnuts	stallung
dragomen	dormagen
galliard	gaillard
atwitter	wattiert
besmirch	bremisch
drawling	ringwald
drearier	radierer
drearies	radreise
hellcats	schallte
drenches	dreschen
potshots	hotspots
seedling	gesindel
aperient	parteien
surefire	friseure
heptanes	stephane
posterns	sponsert
hereinto	theorien
heritors	hierorts
supermen	rumpesen
herniate	heiraten
betatron	bernotat
heroines	roheisen
sedatest	seestadt
porkpies	periskop
hiatuses	aussieht
trickish	kritisch
sunbathe	abhusten
mendable	abmelden
unmasker	kameruns
warthogs	hogwarts
unmarked	denkraum
hireable	reibahle
hitchers	thiersch
breacher	erbacher
calabash	saalbach
holistic	stilicho
vitiator	vittoria
homagers	gehorsam
searched	erdachse
homebred	oberhemd
tremolos	moselort
vitreous	virtuose
homesick	komische
earnable	balearen
unloader	euroland
poetries	posierte
battened	debatten
treetops	proteste
treeless	steelers
poachier	parochie
subdepot	busdepot
scumming	cummings
plushier	spieluhr
derivers	diverser
plunders	sprudeln
plumpens	plumpsen
plotters	stolpert
eeriness	eisernes
apostles	apostels
huckster	kutscher
strophic	tropisch
travelog	vogelart
trashmen	hamstern
trashing	risthang
stressor	ressorts
autodial	laudatio
stoppers	propstes
trammels	stammler
pitchers	pritsche
tramless	erstmals
elkhound	hundeklo
amirates	maserati
trainees	sanierte
emanator	atomaren
tradable	adalbert
bindable	abbilden
immature	mietraum
sauteing	augstein
imminent	einnimmt
saunters	transuse
impacter	campiert
unhealed	handeule
deringer	erdinger
impeller	perlleim
impellor	promille
unharmed	damenuhr
phonetic	pinochet
airspeed	sparidee
enchains	anschein
ungenial	launigen
importer	reimport
encroach	cochrane
imposter	peristom
amniotes	maoisten
persians	spaniers
mediates	mediaset
endbrain	abrinden
sandiest	eisstand
periling	pilgerin
tennises	einstens
unfeared	aufreden
penuries	neupreis
stenches	sechsten
energize	erzeigen
unerring	irrungen
steerers	ersteres
ableness	belassen
pelorias	polareis
uneasier	eurasien
engraver	verargen
slipover	vorspiel
enlarger	erlanger
sailable	isabella
enricher	reichern
meanness	anmessen
undreamt	umrandet
paunches	schnaupe
wallower	wollware
stashing	hastings
meanings	siegmann
sadirons	radisson
entailer	lateiner
entangle	anlegten
entering	regentin
passable	passabel
partaken	karpaten
indorsee	dosieren
underran	anrudern
indulges	siedlung
entrains	arnstein
entrants	transnet
torrents	sternort
entreats	ertasten
inerrant	trainern
underbid	dreibund
inexpert	expertin
aerating	garantie
papillae	lappalie
standers	strandes
envision	visionen
infernos	insofern
inferred	erfinder
runtiest	urintest
panniers	spaniern
inflated	tiefland
inflater	flaniert
bitterns	bestirnt
whiniest	hinweist
rummiest	summiert
palettes	spaltete
rumbaing	baumring
awfuller	wallufer
inherent	hinteren
caroused	ecuadors
inlander	ladnerin
erotized	dozierte
alarumed	laderaum
overseen	veronese
blamable	blamabel
overland	vorladen
overfill	vollreif
instants	tastsinn
blanches	schnabel
routemen	monteure
outstare	eurostat
insulate	litauens
insulter	turnseil
unbridle	dubliner
funkiest	kufstein
craniate	caterina
cranking	rangnick
funereal	erlaufen
apricots	piscator
eternals	straelen
admitter	radmitte
etherize	hetzerei
ethnical	nachteil
batching	nachgibt
ordained	androide
unbacked	abducken
internal	talrinne
orations	ontarios
ropiness	pression
euglenas	auslegen
rootless	torloses
creakier	rackerei
batchers	bratsche
operandi	parodien
operable	operabel
tonnages	sonntage
olympiad	polyamid
bleeders	derselbe
tensible	liebsten
cremator	mercator
everting	verneigt
brandies	brandeis
arabesks	barkasse
inverted	verdient
blindage	baldigen
toileted	deloitte
brandied	dreiband
ritziest	reitsitz
catheter	erachtet
spottier	postiert
matinees	amnestie
isotherm	stroheim
rinsable	baslerin
alderman	andermal
iterated	datierte
blockier	leibrock
tentered	rettende
rigadoon	giordano
japanner	japanern
rideable	dalberei
rickshas	sakrisch
richness	schreins
spoilers	lospreis
rezoning	zornigen
rewinder	erwidern
whenever	verwehen
reuniter	turniere
misstate	missetat
alertest	telestar
tithable	biathlet
tzarists	ratssitz
mistaken	semantik
retinted	tendiert
tiresome	mosterei
wineries	reiswein
brakemen	abmerken
northers	strohern
retailer	realiter
brakeman	makabren
tinwares	warstein
faltered	erdfalte
falterer	elferrat
spikiest	skipiste
frontage	frageton
kerosine	irokesen
ketchups	ketschup
abuttals	sattblau
dentines	diensten
resonant	anrosten
farriers	ferraris
cerulean	laurence
kilotons	kolonist
resolver	vorleser
resoling	solinger
farthest	fahrtest
kindlers	kriselnd
abutters	baustert
fastness	nassfest
sphering	pershing
spherics	persisch
fatigues	aufstieg
chaffers	schaffer
klatches	klatsche
tincture	cutterin
chainmen	eichmann
absenter	anstrebe
knelling	klingeln
chairmen	macherin
modeling	goldmine
feasting	saftigen
nobelist	tonsilbe
feathers	seefahrt
feelings	felsigen
chamfers	scharfem
rarefier	ferreira
chamisos	mosaisch
feldspar	rapsfeld
repliers	perlreis
aneurism	suriname
tertials	lasttier
windfall	fallwind
changers	schragen
ferriage	fragerei
dairymen	myriaden
dalesman	mandelas
spearing	pasinger
reorient	rotieren
chanties	steinach
lamented	anmeldet
lamenter	mentaler
chantors	stronach
festered	festrede
nickered	dickeren
chaplets	spachtel
landward	waldrand
wretches	schwerte
renewing	gewinner
dandling	landding
bolthead	theobald
chargers	gescharr
charging	garching
chariest	astreich
danseurs	saunders
renaming	germanin
larruped	plaudrer
neutrals	lauterns
darkened	dankrede
charnels	rascheln
lassoing	gislason
neurones	neurosen
wetlands	westland
bondable	abendlob
figeater	feiertag
latherer	erhalter
rarities	arisiert
nettlier	erlitten
filchers	fischler
filename	fanmeile
nestlike	kleinste
launcher	relaunch
smirched	schmider
tibetans	batisten
nereides	reisende
lavender	verladen
vacation	octavian
twinkled	weltkind
finagler	fragilen
remaking	markigen
remained	ideenarm
chaufers	saufrech
fineable	abfeilen
fineness	finessen
bonneted	tobenden
leaguers	ausleger
fingered	greifend
abounded	duoabend
leakiest	eiskalte
winchers	schwerin
leanings	signalen
cheapens	pechnase
armenian	marianne
negators	estragon
finniest	tiefsinn
negating	giganten
leathern	erhalten
banisher	inhabers
relining	ringlein
reliever	verliere
chymists	mystisch
turnable	brutalen
leeching	gleichen
mantises	mantisse
alkaline	kanaille
necrosis	ericsson
bankable	abkalben
chutnees	scheuten
neckties	eckstein
checksum	schmucke
fishmeal	filmhase
fishpole	spielhof
deafness	fassende
fitchews	schweift
cheerier	erreiche
cheering	griechen
cheerios	ochserei
dearness	adressen
throwers	ortswehr
cheesing	schneeig
naturals	turnsaal
chelates	tacheles
natriums	martinus
reinsmen	mesnerin
armoured	marodeur
reindeer	niederer
frenzied	erzfeind
flangers	fernglas
narrates	rasanter
bantered	beratend
banterer	beratern
liberate	ableiter
librated	libertad
flashier	halsfrei
welchers	wechsler
freehand	fahrende
freaking	grafiken
rehandle	darlehen
flatters	startelf
lifespan	feilspan
threaten	theatern
ligature	gaultier
regattas	stargate
mandates	damasten
regained	agierend
tetchier	richtete
arraigns	grasrain
flitches	festlich
twangler	weltrang
chunkier	neukirch
acanthus	anschaut
aflutter	futteral
childing	dinglich
florists	fristlos
flossier	fossiler
solvable	boleslav
baseness	besassen
mushiest	theismus
bareness	essbaren
borstals	blassrot
localist	castillo
murkiest	umkreist
solarize	sozialer
bargeman	abmagern
snappier	persipan
munchers	urmensch
botanist	obstinat
bothered	bedrohte
chiseled	deichsel
annulate	anlauten
barmiest	stabreim
bottomer	moorbett
chloride	chorlied
definers	friedens
soberest	oberstes
arteries	reiseart
redlines	siedlern
thesauri	haustier
redeploy	polyeder
tutelage	gelautet
baronets	abrosten
lukewarm	maulwerk
muchness	schmusen
choppers	schopper
snowiest	sonstwie
forelegs	erfolges
dehorned	drohende
dehorner	horrende
theories	reithose
forewent	freetown
chortles	rechtlos
machetes	seemacht
barrette	abtreter
wizening	winzigen
motormen	metronom
motorist	osttimor
delegant	gelandet
rebaters	beraters
urbanize	zauberin
madhouse	modehaus
deleting	gleitend
motioner	monitore
snitches	estnisch
magneton	montagne
deliming	meidling
urbanism	submarin
fortuned	fundorte
mortared	mordrate
realness	erlassen
fourteen	notfeuer
thalamic	malachit
foulards	drauflos
maintops	imposant
meuniere	neumeier
sneering	ersingen,rennsieg
teazling	langzeit,zeitlang
briefest	bierfest,festbier
chippers	schipper,schrippe
chillers	schiller,schrille
thornier	rohrniet,horntier
mutineer	mutieren,umreiten
britches	schreibt,berichts
chickens	neckisch,schicken
chertier	erreicht,reichert
lichened	endliche,liedchen
widening	inwendig,windigen
churners	schnurre,schurren
libeling	liebling,billigen
neckwear	wackeren,warnecke
reliable	liberale,ballerei
armholes	erholsam,harmlose
banister	brisante,antriebs
launches	lauschen,schlauen
testable	belastet,bastelte
frigates	freitags,gastfrei
bandeaus	saubande,ausbaden
alieners	lineares,lasieren
feetless	lesefest,fesselte
feasters	erfasste,teerfass
tinkered	direkten,krediten
martinet	minarett,mitraten
taunters	neustart,erstaunt
absented	besandet,stabende
destrier	dreister,strieder
mistaker	maskiert,kreisamt
colinear	cornelia,caroline
greenier	regieren,gerieren
aldermen	dermalen,anmelder
garlands	drangsal,grasland
ditchers	dichters,erdsicht
blencher	blechner,blechern
wildfire	freiwild,wilfried
operants	pastoren,paterson
unbarred	erdbraun,abrudern
ranchers	scharren,schnarre
oriented	editoren,dotieren
interest	streiten,testerin
esthetic	sichtete,teetisch
watchers	sachwert,schwarte
burettes	brusttee,bestreut
enlarged	endlager,darlegen
perchers	prescher,sprecher
endanger	ragenden,anregend
enabling	langbein,balingen
horrible	bleirohr,horribel
earthmen	ehrenamt,ermahnte
sentries	steiners,tessiner
polentas	ostalpen,aposteln
trenches	rechtens,restchen
suitable	bauteils,baustile
trickers	stricker,trickser
besmears	messbare,erbmasse
dragline	reginald,girlande
sweeting	steinweg,wenigste
hastened	ehestand,dastehen
weensier	erweisen,erwiesen
bleeding	lebendig,gebilden
battener	erbtante,betraten,abtreten
ensnared	rasenden,andresen,andersen
riveters	serviert,verreist,versiert
returnee	erneuert,erneuter,teureren
sneezier	eisenerz,sezieren,szenerie
chiseler	schieler,schleier,schliere
refuting	unfertig,frutigen,fungiert
cherries	schierer,schreier,sicherer
retainer	narretei,tarieren,arterien
keratins	riskante,kanister,skaterin,transkei
notchers	schroten,stochern,storchen,tornesch
enriches	erschien,schiener,schieren,schreien,schreine,sicheren


processing division 9

chastened	schadeten
zoologies	soziologe
sideliner	siedlerin
menarches	schneearm
accordion	concordia
millstone	mitsollen
melanists	einstmals
medallion	medaillon
meantimes	amtsmiene
mischarge	magischer
mealtimes	stammelei
mattering	mittragen
matriline	tramlinie
mistiness	steinsims
aeronauts	naturoase
wondering	nirgendwo
martialed	diametral
modernest	modernste
witchiest	weitsicht
manhandle	landnahme
manginess	geissmann
disagreed	siedegrad
airstream	samariter
maltreats	amtsalter
windstorm	windstrom
allergist	literglas
signalmen	seligmann
motorists	osttimors
lunkheads	sandkuhle
muckraker	uckermark
lotteries	ortsteile
whirliest	wiltshire
litigates	talseitig
muttering	umgittern
ancestral	lancaster
lichenins	sinnliche
librettos	brisolett
libraries	brasilier
liberties	seiltrieb
liberians	brasilien
liberator	laboriert
aneurisms	masseurin
libelants	abstillen
angeluses	aussegeln
angleworm	normalweg
wesleyans	asylwesen
lessening	esslingen
anisettes	seitenast
nebraskan	rasenbank
legislate	steillage
dismantle	mistladen
legations	nostalgie
legalists	stielglas
lecithins	tischlein
lecheries	selcherei
antinovel	valentino
neutering	ungeniert
watermark	marktware
lappering	grippalen
languages	augenglas
nicknamed	dieckmann
laminated	dalmatien
lamenters	erstenmal
aphanites	phantasie
laborites	arbeitlos
nitrating	intrigant
warhorses	rohwasser
nominated	dominante
apprisers	sparpreis
apronlike	kapriolen
vitiators	visitator
nontenure	neutronen
kerneling	erklingen
kerchiefs	kreischef
assumable	laubmasse
numbering	umbringen
nutriment	mitturnen
athelings	steilhang
athenians	hanseatin
attenders	startende
attestant	attentats
augmenter	argumente
authoress	osterhaus
veniremen	vermeinen
veneering	verneigen
oilpapers	papierlos
avouchers	voscherau
omnibuses	omnibusse
simulants	stimulans
varieties	avisierte
baedekers	bederkesa
internees	steinerne
banisters	brisantes
bannister	brisanten
interlude	endurteil
barbering	bibergarn
digestant	diensttag
interlace	lancierte
disrepute	spediteur
interfere	erntereif
urbanizes	zinsbauer
bassinets	bassisten
batteners	anstrebte
uprooters	eurosport
interbank	abtrinken
insurable	erlaubnis
beechnuts	besuchten
beginners	begrinsen
instarred	stirnader
untenable	entlauben
untangled	entladung
unstinted	studentin
overdrunk	nordkurve
beltlines	stilleben
unshackle	schaukeln
unripened	einpudern
dialogues	douglasie
bermudian	baumrinde
beseecher	eberesche
detouring	dotierung
inshrined	hindernis
overtures	vorsteuer
inpatient	patientin
unlatches	lauschten
biennials	libanesin
innervate	veteranin
inherence	einrechen
billeting	billigten
unhitches	unethisch
ungulates	augenlust
infesters	streifens
inferable	abliefern
unfertile	unterlief
unethical	lichtenau
uneasiest	seitenaus
birrettas	streitbar
inertness	entrissen
underwent	wunderten
inebriate	einarbeit
paroquets	sparquote
indorsing	girondins
underrate	trauernde
underling	linderung
bisulfate	feilstaub
underarms	andersrum
bitchiest	tibetisch
passerine	passieren
indigenes	ingesinde
pastiches	aseptisch
pasturers	superstar
unclothes	schulnote
patentors	patterson
unclasped	landescup
uncertain	nuanciert
unbending	bindungen
bleaching	angeblich
blenchers	scherbeln
unaligned	einladung
unalarmed	ladenraum
inclosure	cornelius
blotchier	oberlicht
bludgeons	besoldung
penholder	opernheld
twitchier	teichwirt
boneblack	abblocken
peregrins	sperrigen
perennial	planieren
perilunes	pulsieren
tutorages	tagestour
turmoiled	moduliert
persister	priesters
pertinent	terpentin
dethroner	thronrede
petrifies	tiefpreis
disturber	bierdurst
phonetics	optischen
bullheads	halbdusel
bungholes	besohlung
triplanes	pilastern
tressiest	tristesse
pinsetter	sprintete
identifer	definiert
treasured	steuerrad
transmute	untermast
transfuse	unerfasst
transform	strafnorm
plainsmen	spielmann
camshafts	mastschaf
tramplers	strampler
plasterer	talsperre
trainable	albertina
platooned	datenpool
hungering	hungrigen
humectant	umnachtet
plebeians	abspielen
trackings	stickgarn
plottiest	testpilot
disuniter	industrie
hoopsters	sporthose
honorable	honorabel
totterers	stotterer
polluters	supertoll
hindrance	dachrinne
portliest	sportteil
herniates	eisenhart
hermitage	geheimrat
detailing	digitalen
heretical	achterlei
heraldist	drahtseil
tolerable	tolerabel
helpmates	stehlampe
pouchiest	utopische
dobermans	marsboden
preachier	pracherei
tinplates	spaltniet
precising	piercings
headlined	heideland
channeled	lachenden
preinsert	priestern
chartists	ratstisch
meritable	blamierte
chastener	erachtens
chastiser	artesisch
thurifers	ruhefrist
doggerels	geldsorge
presifted	seitpferd
dominates	todeinsam
cherishes	seherisch
chestfuls	schulfest
handlebar	handelbar
thirteens	hinterste
chinkiest	kinetisch
chiselers	schlesier
chiseling	gleichnis
chiseller	leserlich
halftimes	amtshilfe
chitlings	stichling
chittered	erdichtet
slathered	drahtesel
thereunto	totenruhe
proceeder	procedere
hairlocks	kalorisch
christies	steirisch
tetragons	torstange
dosimeter	demetrios
chucklers	schlucker
tetanuses	austesten
testatrix	streitaxt
terminate	mattieren
termagant	gartenamt
pronators	pornostar
tenancies	cineasten
teleports	stolperte
protested	spottrede
teetering	tigerente
teentsier	testieren
growliest	wortselig
pruderies	reispuder
grittiest	strittige
teachings	angesicht
ptomaines	imposante
semestral	seltsamer
greeniest	ersteigen
greenbelt	engelbert
greasiest	reisegast
graveness	versagens
tastiness	assistent
grandames	smaragden
graduates	dauergast
governors	vorsorgen
governing	vorgingen
governess	vergossen
purchaser	ursprache
tardiness	streisand
glassfuls	glasfluss
draftiest	freistadt
gladelike	klagelied
seesawing	weissagen
gemutlich	gleichmut
geminated	medientag
gelatines	langseite
gauntlets	ungestalt
gateposts	tagespost
garniture	traurigen
gaberdine	dreingabe
fulminate	mitlaufen
frontages	stenograf
frivolled	friedvoll
rapturous	usurpator
freshener	fernseher
freeloads	ledersofa
fourteens	feuersnot
fortunate	totenfrau
surgeries	regisseur
reassumed	ausserdem
forgather	torgefahr
reddening	dringende
subgenera	rausgeben
subeditor	diebstour
reenslave	verleasen
reentries	reisernte
fluorenes	losfeuern
refigured	redefigur
refrained	radreifen
dramatize	zeitdrama
refulgent	regenflut
refunding	erfindung
flinchers	schilfern
fleetness	fesselten
stretcher	erstrecht
stressful	fresslust
rehandled	handleder
rehandles	darlehens
flannelet	entfallen
flanneled	fallenden
seemliest	leitmesse
stratagem	grasmatte
reindeers	reisender
reinforce	forcieren
reinfuses	fresenius
reinsured	rundreise
rekindles	kriselnde
relatione	orientale
dreariest	dieserart
stitching	schnittig
stitchers	schrittes
remigrate	margerite
figeaters	feiertags
fettering	fertigten
sterilize	ziseliert
stereoing	ortseigen
reparable	reparabel
ferneries	fernreise
repentant	penetrant
slouching	unlogisch
felonries	loseifern
steersmen	semestern
steadings	dienstags
statesman	senatsamt
repulsing	ringspule
stateable	salatbeet
reputable	reputabel
faultiest	auflistet
seatmates	metastase
fatteners	entsafter
depilates	piedestal
resenting	rennsteig
farseeing	fangreise
restating	stagniert
restraint	starterin
scrofulas	crosslauf
retention	notierten
retrained	tradieren
retreated	tetraeder
retrieval	relativer
sneakiest	eiskasten
creakiest	eitersack
revenging	vergingen
reverends	versender
rewedding	weddinger
richfield	friedlich
spleenier	erspielen
scheduler	schleuder
spinaches	spanische
elegizing	engzeilig
cushiness	einschuss
sphincter	pritschen
spherical	archipels
robustest	streuobst
rockeries	reiserock
spendable	spendabel
roentgens	entsorgen
roisterer	sortierer
elemental	metallene
eternizes	einsetzer
estranged	gesandter
definable	abfiedeln
eruptions	petronius
datelines	landseite
saturnine	unsaniert
equalises	quasselei
deaneries	eisenader
runagates	austragen
debarment	meterband
debenture	betreuend
softeners	rosenfest
sortieing	soigniert
enchained	eindachen
enchanter	nachernte
enslavers	verlassen
enrichers	schreiner
saintlier	realistin
engravers	vergrasen
enfolders	rosenfeld
enfetters	erntefest
energizes	eisgrenze
endpoints	disponent
sanguines	aussingen
enciphers	speichern
sickening	sickingen
ensnaring	angrinsen,nasenring
entertain	internate,eintraten
sparkiest	preisskat,spastiker
eschewing	schwiegen,schweigen
eucharist	ausreicht,tierschau
spillable	ballspiel,spielball
spinneret	serpentin,rennpiste
retrieves	versierte,servierte
retailing	interliga,gratlinie
starchier	erratisch,reichsrat
mentioner	montieren,monierten
aigrettes	strategie,gastierte
fireplugs	preisflug,flugpreis
maelstrom	osterlamm,sammelort
refueling	lieferung,riefelung
genitures	urgestein,gustieren
anointers	senatorin,rosinante
derisible	bildserie,reisebild
greetings	gestrigen,geringste
entangler	erlangten,angelernt
thickener	techniker,kitchener
cherenkov	verkochen,verhocken
cheeriest	scheitere,stecherei
destriers	dressiert,strieders
heartsick	arktische,kaschiert
heritable	teilhaber,halbierte
detainers	seidenart,eierstand
hotnesses	osthessen,hostessen
bucharest	berauscht,schraubte
breasting	steingrab,grabstein
besiegers	essbegier,eisberges
unrefined	unfrieden,fundieren
ornaments	ostermann,ortsnamen
interleaf	lieferant,altreifen
profiteer	tieropfer,opfertier
intervene	vernieten,verneinte,vereinten
tanneries	sanierten,anstieren,einrasten
reignites	signierte,steiniger,einstiger
reseating	angereist,sagentier,gasteiner,gastieren
stenchier	sicherten,erscheint,schreiten,scheitern,streichen,reichsten


processing division 10

tormentors	sternmotor
pastorates	staatsoper
alchemists	maltesisch
anguishing	hinausging
inconstant	constantin
lengthiest	leithengst
ultrafiche	fachurteil
vermonters	verstromen
garrisoned	grandioser
blundering	erblindung
peninsulas	auspinseln
gaberdines	siegerband
misreports	strompreis
fulminated	mitlaufend
leathering	hinterlage
mensurable	lebensraum
shoplifter	sporthilfe
franchisee	faschieren
invariable	invariabel
dirigibles	dreisilbig
reanimates	ameisenart
concretion	concertino
surfeiting	steinfigur
reassuming	massierung
intrenches	entsichern
supporters	supersport
formidable	formidabel
rebounding	beiordnung
rebroadens	sonderbare
intramural	ultramarin
aerologist	astrologie
foreigners	sorgenfrei
antipodean	adaptionen
substratum	staubsturm
substation	busstation
neutralism	trauminsel
interregna	rangierten
subletting	blutigsten
abnegators	ortsangabe
burglaries	silbergrau
reemerging	geringerem
reenslaves	verlassene
balladries	bildersaal
interpolar	pontarlier
medallions	medaillons
machinists	maschinist
refineries	serienreif
antiserums	misstrauen
refreezing	freigrenze
intermixes	exminister
regalities	egalisiert
ordainment	antimodern
dishearten	eisendraht
rehardened	daherreden
strategies	geistesart
lamentable	lamentabel
reinflamed	marienfeld
reinflames	marienfels
interlocks	stirnlocke
strangered	gastredner
signatured	staudinger
reinserted	erdreisten
reinstates	asterstein
clodhopper	doppelchor
identifers	dienstfrei
intergroup	portierung
mouthparts	hauptstrom
treadmills	altersmild
fingernail	filigranen
interfaith	inhaftiert
remodeling	morgenlied
remorseful	leserforum
transients	tennisstar
remounting	montierung
renegading	niedergang
sternutate	untertaste
reoriented	rotierende
tramelling	metallring
traitoress	assortiert
underlines	eindruseln
replanting	ringplanet
tragicomic	comicartig
knottiness	konsistent
reschedule	scheuleder
starchiest	statischer
standstill	stillstand
integument	entmutigen
resonating	organisten
resounding	sondierung
nominators	astronomin
restrained	ratsdiener
lorgnettes	longstreet
resupplies	superspiel
retainment	teamintern
carbineers	srebrenica
outsmarted	todestraum
retreading	derartigen
retreating	tiergarten
techniques	quietschen
reversible	reversibel
governable	rabenvogel
rewakening	weingerank
unswearing	auswringen
splotchier	sportliche
arbitrates	ratsarbeit
unsteeling	leistungen
unstarched	ratsuchend
spirochete	poetischer
hibernator	hornarbeit
hibernates	eisenbarth
hibernated	handbreite
amendments	stammenden
cashiering	einscharig
portioners	resorption
castration	actionstar
unshackled	schuldekan
unsensible	unsensibel
unsalaried	andalusier
benefiting	bienengift
unsafeties	aussteifen
potentates	etatposten
mischarges	sechsarmig
unresigned	neuerdings
etherizing	ziegenhirt
hectograms	gesamtchor
heartening	hingeraten
besmearing	maisenberg
besmircher	beschirmer
unpleasing	anspielung
epithelial	philatelie
enwrapping	wappenring
artichokes	kroatische
technocrat	trenchcoat
gristliest	erstligist
debutantes	bundesetat
cerecloths	colchester
enthralled	handteller
chafferers	erschaffer
enrichment	mitrechnen
timeserver	vermieters
predestine	spendierte
timeliness	missleiten
unmistaken	musikanten
meagerness	regenmasse
insensible	insensibel
chanteuses	ausstechen
groundless	drosselung
monarchies	romanische
charlatans	scharlatan
inoperable	inoperabel
witcheries	reichsweit
sauntering	signaturen
deferrable	lederfarbe
presenting	sprengniet
assertions	restsaison
snuggeries	genussgier
threnodies	sonderheit
amusements	ausstemmen
scheduling	schuldigen
degreasing	dreigesang
schlemiels	eselsmilch
dekaliters	kaderliste
schmalzier	marschziel
delegating	altgedinge
mutilative	ultimative
priestlier	literpreis
ingredient	dirigenten
eglantines	seitenlang
thickeners	kretischen
astrolabes	albatrosse
thereuntil	unterhielt
chondrites	chordienst
theologian	anthologie
choristers	christrose
wiretapper	wertpapier
chuckholes	kochschule
terminates	amnestiert
slenderize	zersiedeln
senatorian	sanatorien
sentineled	leistenden
biparental	planarbeit
bipartisan	barpianist
unearthing	hantierung
serenities	einerseits
dianthuses	hausdienst
dewatering	angewidert
anesthetic	nachtseite
underwrite	wundertier,unerwidert
lineaments	namenliste,namensteil
asperities	tapisserie,patisserie
entireness	interessen,steinernes
entreaties	teeniestar,reisetante
retrievers	versierter,reserviert
lienteries	serienteil,elitserien
reinvested	verdientes,verdienste
mechanists	semantisch,missachten
raunchiest	trauschein,ausrichten
branchiest	abstrichen,sichtbaren
altimeters	altmeister,amtsleiter
trickeries	trickserie,trickserei,strickerei


processing division 11

lectureship	superleicht
dilettantes	stadtteilen
accessories	accessoires
yardmasters	radarsystem
separatists	staatspreis
desalinates	seidenatlas
seigneurage	greisenauge
inalterable	bilateralen
earthliness	hinterlasse
maturations	raumstation
elaborating	baritonlage
unentangled	entladungen
monetarists	assortiment
enlargement	regenmantel
monochromes	chromosomen
wintergreen	winterregen
estimations	saisonmitte
ethicalness	elastischen
alexandrine	alexandrien
motherlands	stromhandel
machineries	maschinerie
machinelike	chemikalien
multiethnic	lichtminute
countersank	austrocknen
repurchased	sprechdauer
repertorial	proletarier
westernized	widersetzen
sterilities	stilisierte
reorienting	ignorierten
renominates	seniorenamt
inferential	lieferantin
remunerates	mauerresten
nearsighted	geisterhand
legislating	langstielig
mentalities	mittelasien
leatherneck	hecklaterne
netherlands	strahlenden
streakiness	senatskreis
latchstring	schrittlang
antiprotons	sportnation
regimentals	erstmaligen
suggestible	suggestibel
arrogations	organisator
furtherance	frauenrecht
irreparable	irreparabel
generalized	zielgeraden
generations	seniorentag
gingerbread	randgebirge
telekinesis	kieselstein
omnipresent	prominentes
interveners	versteinern
tensiometer	meteorstein
terminators	rotarmisten
progenitors	sportregion
theatricals	staatlicher
hereinafter	reiterfahne
unrelenting	rennleitung
unrehearsed	herausreden
overspreads	vorderpasse
overtrained	vordatieren
butterflies	berufstitel
inheritable	teilhaberin
ingredients	niedrigsten
unharnessed	hunderassen
infestation	sinfonietta
uncherished	durchseihen
neanderthal	handlaterne,anhaltender
marchioness	romanisches,osmanischer
searchlight	halsgericht,lethargisch


processing division 12

merchantries	marschierten
legionnaires	seniorenliga
greenishness	heringsessen
leatheriness	haselsteiner
weatherglass	wassergehalt
everblooming	vorbeimogeln
misrepresent	pressetermin
abolitionism	mobilisation
interpolates	seitenportal
internalized	indianerzelt
profiteering	topfreiniger
interchanges	angestrichen
thunderclaps	durchspalten
preparations	sopranpartie
rhetoricians	oraniertisch
neckerchiefs	ferienscheck
merchandised	manderscheid
unregimented	turngemeinde
tragediennes	stagnierende
supermarkets	supermarktes
unprofitable	unprofitabel
transferable	transferabel
unchristened	innerdeutsch
rattlesnakes	staatslenker
personalizes	losspazieren
disagreement	gemeinderats
stepchildren	lichtspender
irreversible	irreversibel
undercharges	schnurgerade
paternosters	seetransport
rescheduling	niederschlug,reichsgulden


processing division 13

disemboweling	wimbledonsieg
disentailment	mindestanteil
unhealthiness	hinausstehlen
overreactions	conservatoire
traditionless	saisondrittel
ambitiousness	staubemission


processing division 14

overstretching	vorgeschritten


processing division 15



processing division 16



processing division 17



processing division 18



processing division 19



processing division 20



processing division 21



processing division 22



processing division 23



processing division 24



processing division 25

2
